gazateci=journalist
çalışkan=hardworking
bulaşıklar=dishes
apartman dairesi=flat
madde/malzeme=material
takım elbise=suit
sepet=basket
fırın=oven
tozlu=dusty
raf=shelf
kalın=thick
etek=skirt
akşam yemeği=dinner
öğle yemeği=lunch
hasta=patient/ill
çanta=purse
ayakkabı=shoes
sarışın=blond
pantolon=trousers
gömlek=shirt
krvat=tie
tamirci=mechanic
askeri=military
garson=waiter
terzi=tailor
satış=sales
alt kat=downstairs
şehir merkezi=downtown
ortalama=average
dikmek=sew
ayrılmak=leave
iyi geçinmek=get on well
geri gelmek=get back/come back
ateş/yangın=fire
bilgi=knowledge/information
alan/saha/tarla=field
yetişkin=adult
tava=pan
ocak=stove
dökmek=pour
kırmak/çatlatmak=crack
kase=bowl
karıştırmak=stir
tabak=plate
kaşık=spoon
uçuş=flight
zemin=floor
çatal=fork
komik/eğlenceli=funny
üzüm=grape
silah=gun
süpürmek=sweep
dükkan=store
elbise=dress
getirmek=bring
dışarıda=out side
yetiştirmek=grow
tür=kind
-mek amacıyla=in order to
kurtulmak=get rid of
alışkanlık=habit
yarım=half
üzgün=upset
duymak=hear
kalp=heart
vergi=tax
düzine=dozen
çıkarmak=take out
cep=pocket
memnun=glad
atmak(kalp)=beat
zirve,tepe=peak
söylemek=say
karar vermek=decide
değişik/farklı=different
sebep olmak=cause
akıllı/zeki=smart/intelligent/clever
başarılı=successful
güzel=pretty
strong=güçlü
birlikte=together
gülmek/kahkaha atmak=laugh
gemi=ship
yolcu=passenger
cami=mosque
hakim/yargıç=judge
avukat=lawyer
denizci=sailor
kayısı=apricot
bodrum=basement
kilise=church
karşısında=across
kafes=cage
makale/kompozisyon=essay
havuz=pool
muhasabeci=accountant
korkmuş=afraid
köprü=bridge
patron=boss
borç/ödünç almak=borrow
şişe=bottle
ağır=heavy
taşımak=carry
cesur=brave
marangoz=carpenter
mobilya=furniture
esnasında/boyunca=during
kırmak=break
büyük/devasa=huge
fırça/fırçalamak=brush
vazo=vase
tutmak=keep
sevimli/tatlı=cute
yemek yenilen oda=dining room
büyü/hece=spell
takvim=calendar
tarih=date
başkent=capital
halı=carpet
çizgi film=cartoon
maaş=salary
açık/net/belirgin=clear
ceket=coat
fırında kızartmak=roast
can sıkıcı=annoying
giymek=put on
büyüleyici=fascinating
kesinlikle=definitely
tatil=vacation/holiday
varmak=arrive
endişelenmek=worry
seyahat etmek=travel
sinirlenmek=get angry
uçak=airplane
yaşamak=live
herhangi bir yer=somewhere
yataktan kalkmak=get up
uyanmak=wake up
her biri=each other
yürüyüşe çıkmak=take a walk
çanta=bag
banyo=bath
fatura=bill
ödemek=pay
kaynamak=boil
sessiz=quiet
inşa etmek=build
uygun fiyatlı/ödenebilir=affordable
yunus=dolphin
balina=whale
deniz kabuğu=shell
eğlenceli=entertaining
görünmek=seem
soğumak=get cold
inek=cow
başlamak=begin
onlar/şunlar=those
boşanmış=divorced
erken=early
kazanmak=earn
nişanlı=engaged
halinde/durumunda=in case of
vermek=give
hediye=present
temel/ilk=elemantary
yeterli=enough
düşmek/sonbahar=fall 
dengeli=balanced
başarı=accomplishment
yetenek=ability
sabit=constant
